that_equipment_market	the_equipment_needed_to_produce_those_chips
U.S._equipment_makers	the_equipment_needed_to_produce_those_chips
U.S._equipment_makers	the_equipment_needed_to_produce_those_chips
A_state_-_of_-_the_-_art_plant	semiconductor_manufacturing
the_technology	semiconductor_manufacturing
that_March	1980
the_vacillation	Mr._Bush
the_vacillation	the_pro-choice_advocate
the_vacillation	the_anti-abortionist
the_mother_'s	abortions
mistrust_and_criticism_from_all_around	this_popular_president
prevention	abortions
a_firm_line	it
The_political_risk	Mr._Bush_'s
The_political_risk	it
the_mother	abortions
federal_funding	abortions
the_volume	His_rhetoric
a_statement	the_ruling
questions	the_ruling
any_new_curbs	abortion
a_position_he_is_neither_comfortable_with_nor_able_to_escape	abortion
party_moderates	GOP
reservations	the_measure
direct_cash_assistance	California
Majority_Whip	the_Senate
federal_aid	a_state_'s
a_veto	the_rape_-_and_-_incest_exemption
often_influential_members	House_-_Senate
a_controlling_stake	Delmed
pricing	a_dialysis_solution_used_in_treating_kidney_diseases
chairman	Delmed
president	Delmed
chief_executive	Delmed
a_director	Delmed
a_consultant	Delmed
chief_operating_officer	Delmed
chief_financial_officer	Delmed
chairman	the_company
president	the_company
chief_executive	the_company
chief_operating_officer	the_company
the_proposal	a_transaction_under_which_Fresenius_would_buy_Delmed_stock_for_cash_to_bring_its_beneficial_ownership_to_between_70_%_and_80_%_of_Delmed_'s_fully_diluted_common_stock
distribution_arrangements	dialysis_products
a_two_-_tier_exchange_rate	the_ruble
a_two_-_tier_exchange_rate	the_dollar
a_two_-_tier_exchange_rate	the_Soviet_Union
The_final_package	a_space_-_based_anti-missile_system
officials	The_White_House
political_parties	Lebanon_'s
military_chief_Aoun_,_who_has_rejected_the_plan_,_which_includes_political_changes_and_a_Syrian_troop_withdrawal_from_Beirut	Lebanon_'s
political_changes	Lebanon_'s
A_department_spokesman	The_Justice_Department
broad_political_and_economic_restructuring	Czechoslovakia_'s
that_unusual_glint	shiny_stones
the_diamonds_uncovered	the_world_'s_most_inhospitable_diamond_dig
the_sand	this_treasure_chest
the_diamonds	Namibia
the_mine_headquarters	The_mining_zone
the_streets	Oranjemund_,_the_mine_headquarters_,
the_flood	the_rising_Orange_River
the_current_estimate_of_10	the_mine_'s_productive_life
the_sand	the_dunes
the_screening_plants	diamonds
the_battering_waves	the_ocean
A_companion_jetty_that_helps_hold_back_the_sea	it
the_waves	the_ocean
a_very_good_advert	Caterpillar
the_diamonds	the_mine_'s
the_sand_swept_away_by_the_men_wielding_shovels_and_brushes_--_the_ignominiously_named_``_bedrock_sweepers_''_who_toil_in_the_wake_of_the_excavators	the_dunes
employees	the_mine_'s
One_man	employees
A_food_caterer	employees
None	employees
mine_security	the_mine_'s
change	South_Africa
sanctions	South_Africa
85_%	the_country_'s_black_population
economic_sanctions	South_Africa
step	everybody_else
formal_approval	the_Food_and_Drug_Administration
advanced_infection	the_disease
the_youngest_patients	AIDS
the_few_exceptions	the_youngest_patients
symptoms	AIDS
somber_satisfaction	The_move
a_daughter_Ariel	Elizabeth_Glaser_,_a_Los_Angeles_mother_and_activist_who_contracted_the_AIDS_virus_through_a_blood_transfusion_,_and_transmitted_it_to_two_of_her_children
any_symptoms	AIDS
critics	The_delay_in_getting_AZT_to_children
the_patient_population	AIDS
the_large_and_lucrative_market	AZT_'s
roughly_50_pediatric_patients	AIDS
some_patients	the_pediatric_syndrome
experts	terrorism
We	A_U.S._counterterrorism_official
the_dialogue	PLO
the_occupied_Arab_territories	Israel
continued_terrorism	Arafat_or_the_PLO
The_new_accusations	It
The_new_accusations	Fatah
incidents_that_involved_civilians_and_occurred_inside_its_pre-1967_borders	it
questionable_claims	Palestinian_terrorism
